╔═════╦════════════╦═════════╗
║    .║  ..      . ║.    .   ║
║.    ║    .       ║ A .     ║
║  .  ╠═══════  ═══╩═ ═╗     ║
║     ║  .            .║     ║
╠═   ═╝   ╔═══    ═════╣.    ║
║        .║           .║     ║
╠═════════╣            ║  .  ║
║   .              .   ║ .. .║
║         ╠════════════╬═════╣
║                 .     A.   ║
║ .       ║            ║   ..║
║      . ╔╩══╦═  ═╦══  ╩═════╣
╠════════╣   ║    ║     .    ║
║  .     ║   ║  . ╠═══╗      ║
║.      A         ║  .       ║
╠════════╝   ║    ║          ║
║            ║    ╠═══╝    . ║
║══ ══╦══════╣    ║.         ║
║  A. ║    .      ║   ╔══════╣
║     ║         . ║   ║ .    ║
║.    ║     .║    ║    A   . ║
╠═ ═╦═╩══╦═══╬═  ═╩═══╩══════╣
║   ║ .  ║  .║               ║
║  .     ║.  ║               ║
║        ║   ║         ╔═   ═╣
╠═ ═╣    ║ A ║   ■     ║   . ║
║ A ║    ╚═ ═╣         ║.    ║
║. .║  .     ║E        ║     ║
╚═══╩════════╩═════════╩═════╝